184 1 2 184 1 2 184 1 2 3 4 5 4 4 4 4 4 4 4 4 6 7 4 4 5 4 4 4 8 9 10 11
12 13 14 12 13 14 12 13 15 16 4 4 17 18 19 4 4 4 4 4 6 7 4 4 4 17 4 70 8 9 10 21
22 23 24 22 23 24 22 23 25 26 4 4 4 6 7 4 4 4 4 4 6 27 19 4 4 4 70 28 29 30 10 11
31 32 33 31 32 33 31 32 34 4 4 35 4 6 27 19 4 35 4 4 36 37 27 19 4 70 28 29 38 39 40 11
41 42 43 44 45 46 47 45 48 5 35 49 50 36 37 27 19 4 4 35 18 51 52 53 70 28 29 38 39 40 11 11
54 55 56 57 58 59 60 58 4 4 5 50 50 4 36 37 27 61 62 19 6 63 7 4 28 29 38 39 40 21 11 64
184 1 2 3 4 4 4 4 4 4 4 4 4 4 4 65 66 67 63 27 51 52 53 4 8 68 39 40 69 11 11 21
12 13 15 16 4 4 70 71 72 72 72 72 72 72 72 73 74 36 37 63 63 7 4 4 8 9 10 11 11 64 11 11
22 23 25 26 4 70 75 76 77 77 77 77 77 77 77 78 79 74 36 37 63 7 4 4 8 9 10 11 11 11 11 21
31 32 34 4 4 75 76 80 4 4 4 4 4 4 4 81 78 79 74 36 37 7 4 4 8 9 10 11 21 11 11 11
47 45 48 4 4 82 83 4 84 49 50 17 4 4 4 4 81 78 79 4 6 7 4 4 8 9 10 11 11 11 64 11
60 58 4 4 4 82 83 85 86 87 88 89 89 90 91 92 4 93 94 4 6 7 4 4 95 9 97 98 11 11 11 11
4 4 4 4 70 82 83 85 4 99 100 101 101 102 103 104 4 93 94 4 6 7 4 5 105 95 96 97 98 11 11 11
4 4 4 70 75 76 106 107 4 99 108 101 101 109 103 104 4 93 94 4 6 7 5 4 4 105 8 9 10 11 11 69
72 72 72 110 76 106 111 4 4 112 114 114 114 114 116 104 4 93 94 117 51 27 19 4 4 5 8 9 10 11 11 11
77 77 77 77 106 111 4 4 118 119 120 121 122 120 123 104 118 93 94 124 63 63 27 125 5 4 8 9 10 11 69 11
4 4 4 126 111 4 4 118 4 127 128 129 130 131 132 133 4 93 94 51 63 63 63 134 50 17 8 9 10 11 11 11
118 4 35 35 4 4 4 35 35 35 4 135 136 4 35 35 4 93 137 138 63 63 138 7 49 49 8 9 10 11 11 11
4 4 35 35 5 4 4 35 35 35 18 139 139 19 35 35 4 93 137 63 63 63 63 7 5 4 95 96 97 98 11 21
4 118 35 35 4 17 4 4 4 4 6 52 140 53 4 4 4 93 137 63 63 138 63 7 4 5 105 95 96 97 98 11
4 4 4 141 142 4 143 144 145 145 36 53 4 145 145 145 4 93 137 63 138 63 146 7 4 4 4 105 95 96 97 147
148 148 148 153 150 4 151 152 148 148 148 148 148 148 148 148 148 153 154 63 63 63 63 27 19 4 35 4 105 95 96 97
156 156 156 157 18 139 19 158 156 156 156 156 156 156 156 156 156 38 159 63 63 63 63 63 27 19 35 35 4 105 95 160
161 161 161 162 6 63 7 163 164 164 164 164 164 164 164 164 164 159 177 63 63 146 63 63 63 27 19 35 35 4 105 165
139 139 139 139 51 63 27 139 139 139 51 63 63 63 63 63 63 63 63 63 63 63 63 63 63 63 27 139 139 139 139 139
140 140 140 140 140 140 140 140 140 140 140 37 63 63 138 63 63 52 140 140 140 140 140 140 140 140 140 140 140 140 140 140
4 4 4 4 70 71 72 73 74 4 4 36 37 52 37 52 166 167 168 169 169 169 169 169 169 169 169 169 169 169 169 169
72 72 72 72 110 170 171 172 173 72 73 74 65 167 65 167 4 168 174 176 176 176 176 176 176 176 176 176 176 176 176 176
171 171 171 171 171 177 63 63 171 171 172 79 74 4 5 4 168 174 179 170 171 171 171 171 171 171 171 171 171 171 171 171
63 138 63 63 63 138 63 63 63 138 63 172 79 4 4 17 174 179 170 177 63 63 138 63 63 63 63 63 63 63 63 146
63 63 63 63 138 63 63 138 63 63 63 181 94 4 4 4 82 182 183 63 63 63 63 63 63 63 63 138 63 63 63 63
63 63 63 63 63 63 63 63 63 63 63 181 94 4 4 4 82 182 183 63 146 63 63 63 63 63 63 63 63 63 63 63